5 5
1 0 0 0 0
1 0 1 0 0
0 0 2 1 0
0 1 2 1 0
0 0 0 0 0
2
1 2
3 1
2 3